7 7
5 2 5 2 3 3 1
4 5 2 4 5 5 4
3 2 1 2 6 6 2
2 2 6 6 2 6 3
2 6 3 6 3 3 5
5 4 5 1 5 1 6
4 5 3 1 5 6 3
0 0 0
6 6 8
