5 5
2 3 2 6 4
5 5 4 3 6
4 3 5 3 5
5 2 5 6 4
6 5 4 1 2
0 0 0
4 4 8
