9 9
4 2 4 3 3 4 2 3 5
5 1 1 3 4 3 5 1 5
5 6 2 1 4 4 4 4 1
3 5 5 5 5 3 3 4 1
2 6 4 4 5 1 5 2 2
5 2 1 4 3 3 3 2 2
1 5 3 2 2 5 2 3 1
3 5 1 3 3 2 2 1 4
3 2 2 2 1 5 1 6 2
0 0 0
8 8 8
