5 5
1 2 3 5 2
2 5 1 5 4
3 5 6 2 4
3 4 3 2 2
1 3 5 2 1
0 0 0
4 4 8
