5 5
5 5 2 1 3
1 6 6 4 3
2 2 1 2 6
5 6 1 4 3
3 2 2 4 5
0 0 0
4 4 8
