7 7
4 3 3 6 3 1 2
3 4 6 6 4 3 4
3 1 6 5 6 2 1
2 5 2 2 3 1 1
4 6 3 4 3 1 2
6 4 4 3 4 3 5
1 5 5 3 3 6 2
0 0 0
6 6 8
