5 5
4 3 5 4 2
5 4 3 5 5
6 5 1 3 6
5 2 2 5 4
5 1 2 2 3
0 0 0
4 4 8
