9 9
6 2 6 6 4 3 1 5 4
1 2 5 4 2 5 1 3 3
6 5 1 3 4 2 2 3 2
3 3 3 2 5 5 2 5 1
6 4 5 3 2 5 2 3 4
4 1 1 5 3 2 6 2 1
1 6 5 1 3 4 2 5 4
6 6 3 5 1 5 4 4 6
6 4 2 1 3 4 2 5 2
0 0 0
8 8 8
