5 5
6 1 4 2 4
2 2 1 1 2
6 6 4 6 6
5 5 6 4 2
4 3 1 3 5
0 0 0
4 4 8
