9 9
4 6 6 3 4 1 6 2 2
2 3 1 1 5 4 4 5 5
4 3 5 1 2 2 6 4 6
5 5 1 3 3 5 2 6 4
5 4 6 1 2 2 1 2 5
3 1 3 5 1 1 5 1 5
1 1 5 2 5 1 5 3 2
5 2 2 1 5 1 5 4 3
2 1 2 5 4 5 4 6 6
0 0 0
8 8 8
