9 9
4 5 3 6 3 2 1 2 4
1 1 3 3 4 3 1 3 6
1 2 1 1 6 3 2 1 2
5 5 1 3 1 2 2 2 5
3 4 5 5 2 2 5 4 2
6 4 3 2 5 2 3 3 5
4 1 4 6 5 3 3 5 4
6 3 1 2 3 5 5 1 5
6 2 3 6 2 5 5 5 1
0 0 0
8 8 8
