9 9
1 4 6 6 2 5 4 3 4
6 4 1 2 6 6 4 5 2
6 6 4 2 3 4 2 3 6
1 3 1 5 3 3 6 4 4
2 1 6 4 4 5 1 2 2
2 4 1 5 6 3 6 2 2
2 3 1 5 5 6 1 1 5
2 2 2 6 2 2 2 6 5
3 2 2 4 1 5 1 4 6
0 0 0
8 8 8
