7 7
4 1 4 5 1 3 5
4 2 6 4 3 3 6
4 6 2 2 6 1 1
3 2 3 5 2 5 2
6 2 1 3 3 3 4
1 4 6 1 6 6 3
1 3 2 1 1 6 1
0 0 0
6 6 8
