5 5
2 1 3 2 6
6 1 5 3 2
1 4 1 1 5
5 6 6 2 6
3 6 2 3 2
0 0 0
4 4 8
