7 7
2 6 2 6 3 6 3
4 6 1 2 5 3 4
6 4 5 4 1 4 2
4 5 6 4 6 5 2
6 3 5 6 4 5 5
5 2 5 6 2 2 3
1 5 5 1 2 6 1
0 0 0
6 6 8
