9 9
4 3 5 5 3 4 1 1 5
4 4 3 5 5 4 6 1 3
5 2 6 3 4 6 1 5 4
3 6 2 3 3 2 1 6 5
6 6 6 5 4 4 2 6 4
1 1 6 3 4 2 1 5 5
2 5 1 1 4 3 5 2 5
1 5 4 2 5 1 5 3 6
5 5 1 6 1 6 4 5 3
0 0 0
8 8 8
