5 5
6 6 4 4 3
2 2 6 6 5
4 5 1 2 5
2 6 2 1 6
6 4 4 6 1
0 0 0
4 4 8
