5 5
1 1 6 1 4
1 6 3 2 5
1 1 1 5 4
1 6 2 1 4
6 3 6 5 5
0 0 0
4 4 8
