9 9
2 3 2 3 6 6 6 2 3
6 3 4 1 5 3 5 2 2
6 6 1 5 1 2 6 2 4
1 1 1 4 1 5 5 5 1
5 2 6 4 2 5 4 1 1
5 6 1 1 2 1 4 2 2
4 4 6 2 3 6 5 6 6
2 1 4 2 6 1 2 5 6
2 6 2 2 6 4 3 6 4
0 0 0
8 8 8
