5 5
4 4 1 5 4
6 4 4 3 2
3 1 3 3 2
3 5 2 5 1
3 6 5 4 3
0 0 0
4 4 8
