7 7
3 2 1 1 2 3 3
1 2 2 4 6 5 4
1 5 1 2 4 1 6
3 1 4 5 6 4 3
2 2 3 5 5 5 5
4 3 4 5 5 3 5
3 6 6 4 5 6 3
0 0 0
6 6 8
