7 7
4 2 5 1 4 1 2
4 6 6 5 4 1 6
3 4 3 6 2 2 6
2 4 2 1 4 4 5
1 2 6 2 4 2 4
6 3 5 2 1 3 5
1 5 1 1 3 2 6
0 0 0
6 6 8
