5 5
2 3 4 2 4
6 3 2 1 1
5 4 4 1 1
3 5 1 5 4
4 4 6 5 1
0 0 0
4 4 8
