7 7
3 1 6 1 4 3 6
1 5 5 6 3 4 1
2 1 4 1 6 6 2
6 3 3 5 1 3 3
4 5 3 5 2 1 5
4 5 6 2 1 3 1
3 5 2 3 1 6 1
0 0 0
6 6 8
