9 9
3 1 3 2 5 2 5 1 6
1 4 2 6 1 6 1 5 5
5 4 1 4 1 5 2 4 5
3 1 2 1 6 2 4 1 2
2 1 6 5 5 3 5 4 3
6 5 1 2 4 3 5 5 5
6 4 6 6 5 1 4 2 4
3 6 5 6 4 3 6 3 4
1 3 6 1 4 3 4 3 1
0 0 0
8 8 8
