7 7
3 3 1 2 4 5 5
6 2 1 1 3 1 2
4 5 6 6 6 5 4
2 2 6 2 3 2 4
5 5 5 4 2 1 3
2 1 4 1 6 3 1
6 6 6 2 4 4 2
0 0 0
6 6 8
