9 9
4 2 5 5 1 2 6 1 3
5 5 6 3 5 1 5 5 3
2 3 6 4 6 2 1 4 3
6 1 6 6 5 1 5 2 1
2 2 3 4 1 4 2 5 4
3 5 4 1 3 6 2 2 4
2 2 2 6 6 6 2 2 5
6 3 3 6 5 1 6 4 6
4 3 4 1 2 6 4 3 5
0 0 0
8 8 8
