9 9
4 6 2 2 6 6 6 1 4
6 5 6 2 2 6 1 4 2
2 3 2 3 4 6 1 3 2
6 3 2 4 6 6 1 6 1
1 5 4 3 6 3 6 3 1
1 4 1 3 6 5 1 3 6
2 6 6 5 4 4 3 4 6
3 1 4 6 4 3 6 4 4
3 2 3 5 4 1 2 3 5
0 0 0
8 8 8
