7 7
2 5 6 4 6 6 4
6 6 1 1 1 2 6
1 4 2 1 4 4 4
2 5 4 2 5 2 2
4 6 3 3 4 6 3
4 4 6 2 1 3 6
4 5 1 4 4 6 6
0 0 0
6 6 8
