7 7
2 3 4 2 4 1 6
2 2 2 6 4 4 6
2 4 6 6 5 5 2
3 2 1 4 3 5 1
2 2 6 4 4 4 2
6 6 6 1 6 1 3
3 5 5 4 6 6 2
0 0 0
6 6 8
